1 1 S 1 1 1 1 1 1 1 1 1
1 0 0 1 1 1 0 0 0 1 1 1
1 1 0 0 0 1 1 1 0 1 1 1
1 0 1 1 0 1 1 0 0 0 1 1
1 0 1 0 0 1 0 0 1 0 1 1
1 0 1 0 1 1 0 1 1 0 0 1
1 0 0 0 1 0 0 1 1 1 0 1
1 1 1 0 1 1 0 0 0 0 0 1
1 1 1 0 0 0 0 1 0 1 1 1
1 1 1 1 1 1 1 1 E 1 1 1
